111111111
10000E001

1CCC00P01
111111111