111111111111111111111
1E0000000000000000001
1P1C11111111111111111
111111111111111111111