111111111111111111111111111111111111111111111111
1E11111111110000C0000011111111110001110C01111001
100000001111110000000000000000000100000001111011
111100111111111110111011011111111111111111111001
100000000000010010000011000000000000000C00000001
100000000000000000000000000000000000000000000001
100000000000100010000000000000000000000000000001
100000110000000000001000000000000010000000000001
100000000100000000000000000000000010000000000001
10000000000011000000P000000000000010000011111001
100000000000000000000000000000000010000000000001
100000000C00110000000000000000000000000000000001
100000000000000000000000011100000011000000000001
10000000000000000000000010101000000C000000000001
100000000011000000000000011100000010000000000001
100000000000000000000000000000000010000000000001
100000000000000000000000000000000000000000000001
100000001111C10000000000001000000000000000000001
100000000000111000000000010100000000000000000001
10000000000000000000000000100000000000000CCCCCC1
100000000C00110000000000000000000000000000000001
100000000000000000000000011100000011000000000001
10000000000000000000000010101000000C000000000001
100000000011000000000000011100000010000000000001
100000000000000000000000000000000010000000000001
100000000000000000000000000000000000000000000001
100000001111C10000000000001000000000000000000001
100000000000111000000000010100000000000000000001
10000000000000000000000000100000000000000CCCCCC1
111111111111111111111111111111111111111111111111